Back Room
This is an unused room behind the stocks. A spare guard uniform hangs from a hook on the wall. Aside from a coffee table and a cheap metal chair, the room is unfurnished.

You're frog-marched inside and given a shove. Over the guard's shoulder, the cashier finishes looking through your handbag. She gives you a look of dripping contempt.

"Stay here. Phil will be back soon to take care of you," the cashier sneers. "You're in so much trouble, missy." The guard just glowers. They file out, taking your handbag with them, and the door closes with an audible click.

So it's a boring day at school, and you'd much rather be out shopping and having fun. Problem is, dear old dad has cut you off. In short, you're broke. No cute shoes or awesome crop tops for you! And there was a sale on, too...

Then again, you're nothing if not resourceful. You were sure there'd be an awesome deal at the mall. So one quick hop over the fence, then over to the bus, and boom!

This is gonna be great, you can tell.

All work, no play
An Interactive Fiction by Vigris
Release 1 / Serial number 170203 / Inform 7 build 6M62 (I6/v6.33 lib 6/12N) SD

Back Room
This is an unused room behind the stocks. A spare guard uniform hangs from a hook on the wall. Aside from a coffee table and a cheap metal chair, the room is unfurnished.

>z
Time passes.

You hear steps outside. A moment later, the door opens. Phil, the security guard, steps into the room. His face is impassive.

"Sit," he tells you.

>z
Time passes.

Phil seems to wait for you to sit down.

>z
Time passes.

"Now! On the chair! I won't ask again!"

>z
Time passes.

Phil's veins are visibly bulging.

>z
Time passes.

Phil looms over you. He grabs your arm. He's really strong.
 
The next moment you're roughly shoved into the chair. "Now sit there and shut up."

Back Room (on the cheap metal chair)
This is an unused room behind the stocks. A spare guard uniform hangs from a hook on the wall. Aside from a coffee table and a cheap metal chair, the room is unfurnished.

Phil is here.

>n
(first getting off the cheap metal chair)
Phil has already shown he's ready and willing to force you down if he feels like it. 
You would have to get off the cheap metal chair first.

* * *

>z
Time passes.

You hear steps outside. A moment later, the door opens. Phil, the security guard, steps into the room. His face is impassive.

"Sit," he tells you.

>sit
(on the cheap metal chair)
You get onto the cheap metal chair. Phil nods, although he still looks kind of angry.

"You damn punks. Think you can get away with anything, do ya?" Phil scowls. "If it were up to me, I'd whip you all like your mommy shoulda. But today for some reason, ooh, that'd be "assault"." He leans forward. "So I'm gonna give you a choice, girl. You can go to the station and wait for your parents to pick you up. I'm sure they'd love to hear all about that. Or you could take your punishment from me until I'm satisfied you've learnt your lesson."

>sit on chair
But you're already on the cheap metal chair.

>stand
One look at Phil's face convinces you not to try.

* * *

>sit
(on the cheap metal chair)
You get onto the cheap metal chair. Phil nods, although he still looks kind of angry.

"You damn punks. Think you can get away with anything, do ya?" Phil scowls. "If it were up to me, I'd whip you all like your mommy shoulda. But today for some reason, ooh, that'd be "assault"." He leans forward. "So I'm gonna give you a choice, girl. You can go to the station and wait for your parents to pick you up. I'm sure they'd love to hear all about that. Or you could take your punishment from me until I'm satisfied you've learnt your lesson."

>l
Back Room (on the cheap metal chair)
This is an unused room behind the stocks. A spare guard uniform hangs from a hook on the wall. Aside from a coffee table and a cheap metal chair, the room is unfurnished.

Phil is looking at you with a faintly menacing expression.

>l
Back Room (on the cheap metal chair)
This is an unused room behind the stocks. A spare guard uniform hangs from a hook on the wall. Aside from a coffee table and a cheap metal chair, the room is unfurnished.

Phil is looking at you with a faintly menacing expression.

* * *

>z
Time passes.

You hear steps outside. A moment later, the door opens. Phil, the security guard, steps into the room. His face is impassive.

"Sit," he tells you.

>l
Back Room
This is an unused room behind the stocks. A spare guard uniform hangs from a hook on the wall. Aside from a coffee table and a cheap metal chair, the room is unfurnished.

Phil seems to wait for you to sit down.

>l
Back Room
This is an unused room behind the stocks. A spare guard uniform hangs from a hook on the wall. Aside from a coffee table and a cheap metal chair, the room is unfurnished.

Phil is here. 

"Now! On the chair! I won't ask again!"

>l
Back Room
This is an unused room behind the stocks. A spare guard uniform hangs from a hook on the wall. Aside from a coffee table and a cheap metal chair, the room is unfurnished.

Phil is here. 

Phil's veins are visibly bulging.

>l
Back Room
This is an unused room behind the stocks. A spare guard uniform hangs from a hook on the wall. Aside from a coffee table and a cheap metal chair, the room is unfurnished.

Phil is here. 

Phil looms over you. He grabs your arm. He's really strong.
 
The next moment you're roughly shoved into the chair. "Now sit there and shut up."

Back Room (on the cheap metal chair)
This is an unused room behind the stocks. A spare guard uniform hangs from a hook on the wall. Aside from a coffee table and a cheap metal chair, the room is unfurnished.

Phil is here. 

"You damn punks. Think you can get away with anything, do ya?" Phil scowls. "If it were up to me, I'd whip you all like your mommy shoulda. But today for some reason, ooh, that'd be "assault"." He leans forward. "So I'm gonna give you a choice, girl. You can go to the station and wait for your parents to pick you up. I'm sure they'd love to hear all about that. Or you could take your punishment from me until I'm satisfied you've learnt your lesson."

* * *

>l
Back Room
This is an unused room behind the stocks. A spare guard uniform hangs from a hook on the wall. Aside from a coffee table and a cheap metal chair, the room is unfurnished.

Phil seems to wait for you to sit down.

>sit
(on the cheap metal chair)
You get onto the cheap metal chair. Phil nods, although he still looks kind of angry.

"You damn punks. Think you can get away with anything, do ya?" Phil scowls. "If it were up to me, I'd whip you all like your mommy shoulda. But today for some reason, ooh, that'd be "assault"." He leans forward. "So I'm gonna give you a choice, girl. You can go to the station and wait for your parents to pick you up. I'm sure they'd love to hear all about that. Or you could take your punishment from me until I'm satisfied you've learnt your lesson."

>l
Back Room (on the cheap metal chair)
This is an unused room behind the stocks. A spare guard uniform hangs from a hook on the wall. Aside from a coffee table and a cheap metal chair, the room is unfurnished.

Phil is here.

* * *

>w
New Shop
Nothing beats a newly opened store trying its best to beat the competition. Obvious concessions to new customers aside, you kinda like what you see on the racks: varied selections ranging from cute to racy to alternative. Decent quality too, although some of it does look kinda pricey. Lots of customers with more money than you are busily queuing up before the cashier.

The makeup stand nearby advertises your favorite brand. Wow, you'd really look awesome in those colors.

The security guard is staring out the window.

>talk to cashier
She's got no time for chit-chat.

>undo
New Shop
[Previous turn undone.]

>rules
Rules tracing now switched on. Type "rules off" to switch it off again, or "rules all" to include even rules which do not apply.

>talk to cashier
[Rule "declare everything initially unmentioned rule" applies.]
[Rule "announce items from multiple object lists rule" applies.]
[Rule "set pronouns from items from multiple object lists rule" applies.]
[Rule "before stage rule" applies.]
[Rule "instead stage rule" applies.]
[Rule "investigate player's awareness before action rule" applies.]
[Rule "player aware of his own actions rule" applies.]
[Rule "check stage rule" applies.]
[Rule "carry out stage rule" applies.]
[Rule "note current interlocutor when greeted rule" applies.]
[Rule "after stage rule" applies.]
[Rule "investigate player's awareness after action rule" applies.]
[Rule "report stage rule" applies.]
[Rule "default greeting rule" applies.]
You say hello to the cashier.

[Rule "last specific action-processing rule" applies.]
[Rule "A first turn sequence rule" applies.]
[Rule "every turn stage rule" applies.]
[Rule "reset protocol rule" applies.]
[Rule "A last turn sequence rule" applies.]
[Rule "notify score changes rule" applies.]

* * *

I beg your pardon?

* * *

>rules
Rules tracing now switched on. Type "rules off" to switch it off again, or "rules all" to include even rules which do not apply.

* * *

>talk to cashier
[Rule "declare everything initially unmentioned rule" applies.]
[Rule "announce items from multiple object lists rule" applies.]
[Rule "set pronouns from items from multiple object lists rule" applies.]
[Rule "before stage rule" applies.]
[Rule "instead stage rule" applies.]
[Rule "investigate player's awareness before action rule" applies.]
[Rule "player aware of his own actions rule" applies.]
[Rule "check stage rule" applies.]
[Rule "carry out stage rule" applies.]
[Rule "note current interlocutor when greeted rule" applies.]
[Rule "after stage rule" applies.]
[Rule "investigate player's awareness after action rule" applies.]
[Rule "report stage rule" applies.]
[Rule "default greeting rule" applies.]
You say hello to the cashier.

[Rule "last specific action-processing rule" applies.]
[Rule "A first turn sequence rule" applies.]
[Rule "every turn stage rule" applies.]
[Rule "reset protocol rule" applies.]
[Rule "A last turn sequence rule" applies.]
[Rule "notify score changes rule" applies.]